
אתגר — этгар... вызов челендж
игнорировать  - להתעלם
ле дугма - к примеру - לדוגמה
מחרפן - нервируешь
משגעת - сводит с ума
амбициозный – שאפתן
ахорей аклаим - за кулисми  - מאחורי הקלעים
браслет - цамид 
буль... точно.. — בול
виновен - אָשֵׁם
воздержаться - להימנע
диалог разговор - שיח
дразнить.. доставать.. - להציק
избежать- להמנע
кейф рецах - убийственно кайфовая
кивяхоль - כִּבְיָכוֹל - как-будто
лав давка - לָאו דַּוְקָא -необязательно
лемазег - למזג - объединить
лехалец — לחלץ – высвобождать ,извлекать
ло ад кидей ках - не настолько. - לא עד כדי כך
меамем מהמם - прекрасно 
мефутар - уволен
мивне - структура, меню - מבנה
мин а стам - на пример
наалим - закрытые (установленные) вещи - נעולים
наказание - עונש
нафаль ли асимон - до меня наконец дошло 
облегчить - משכך
определение – נחישות 
отсортированный - מְמוּיָן 
прежде чем - בטרם
пространство - מרחב
слишком жестоко на мой вкус - אכזרי  מדי לטעמי
убить - להתנקש
хамса хамса - не дай бог
хасифа חשיפה - уязвимость
цорех аиньян - לצורך העניין - к примеру 
эскалатор - מדרגות נעות
אחד משמעי - однозначно 
בולטת - выделяется
במקביל - одновременно, параллельно
העדרות - отсутствие
הקיצוצים- сокращения
זהה - то же самое
חומרה - оборудование
חזון - видение
חנון - ботан
חפיפה - введение в курс дел
חצי קלאץ - хаци клач - (сцепление) пол силы... неоч... такое... 
חריג מאוד-  хариг меод - необычный,исключения
טווחי השכר - зарабатная вилка
ישות— сущность -ешут- ентити 
כלפי מטה - снизу
לא סגור על זה   - не уверен в этом—ло сагур ал зе 
להבריח - контрабанда
להזין- леазин - вводить, питать, кормить
להכפיל - умножить 
להמיר - конвертировать , поменять
להציץ -  взглянуть
להרים דגל - поднять флагсообщить что есть проблема 
להתמקד - сосредоточиться 
לזלזל - недооценивать
לחילופין - как вариант
לחשוף - расскрыть 
לטרוק - хлопать
לסרוק - прочесать
לפצל - разделить
לקלל - ругаться 
לשלב - сочетать соединять объединять
מגוון- разнообразие, спектр
מדחפים - двигатели
מיפוי - отображение
מַנְגָּנוֹן- мангенон - механизм
מצורף בזאת - מצ"ב 
משובש - разрушенный
מתחרים - конкуренты, соревнуемся
מתחרקש - ебать мозг, вмешивается
מתנקש - киллер
מתקתק - тикает
מתרחש - происходит
נחוצים - нужны
ניכר בהחלט - абсолютно очевидно.. 
סיוט - кошмар
ספיר - сапфир
עוף מכובס - оф мехубас - постоянно повторяющася ситуация
על הכיפאק - супер.нормальный, с удовольствием, ура, потрясающе, очень хорошо.
עקום - кривой
פוריה - плодотворная
פער - пар - разрыв, разница
פרטני - индивидуально, по отдельности 
פרעושים - блохи вши
צוואר - шея 
קטלנית - смертельный... офигенно..ужасно.. 
קיצוני - крайний, радикальный
קלוש - слабый
קפצתי להזכיר - поспешил напомнить
רצועה - ремень
שאילתא - шеильта -вопрос
שאיפה- шеифа - амбиции... стремление
שיקול דעת- шикуль даат - взвесить мнения 
תזניחי - пренебрегать
תיקנים - тараканы 
תכולות - содержание
תכולת - содержание
תנחשו - угадайте