a woman of surpassing beauty - женщина непревзойдённой красоты́
abandoned - бросил
Abandoned - заброшенный, оставленный
above - выше, вышеуказанный
above approach - вышеуказанный подход
absent - отсутствует
accepted then i turned it down- я согласился, а потом отказался (reject)
accidentally - случайно
accused - обвиняет
accuses - обвинять
acquainted - знакомый
acquire - приобретать
act of violence — акт насилия
actually - на самом деле
addicted - зависимый
adjust - настроить
admire - восхищаться
adore - обожать
advantages - преимущества
adverbal modifer - обстоятельство
advocacy - защита
affectionately - ласково
afford - позволить , приобрести 
afterwards - впоследствии, позже
agenda - план, повестка дня
agility - ловкость, проворство
alias - псевдоним
alighting - высадка
align -   выровнять
all those responsible for his death will be punished - все ответственные за его смерть  будут наказаны
allow -   позволять
allow explicit content - разрешить откровенное содержание-"эксплик" как и "нетфликc" но только с откровенным содержанием
along - вместе, заодно, с собой, вдоль
altogether -в целом 
alumnus -  выпускник
ambiguity - неоднозначность
ambush - засада
amendment -поправка
ancestors- предки
and tearing us up - и разрывая наши отношения
annually - ежегодно
Anxious - тревожный, беспокойный, сильно желающий 
anytime - в любое время
anyway - в любом случае
apart -  отдельно (друг от друга) -  ( на части)
apologize and maybe i'll consider.. - извиняйся и может быть, я решу..
apostrophe - апостроф (штрих) 
Apparent - очевидно 
appeal - обжалование, призыв, обращение
appeal -привлекает 
appear - появиться
applicable - применимый
appoint - назначать
appointment -   назначение, прием
appropriate - адаптировать, соответствовать
appropriation - присвоение, распределение, выделение
arable and grassland - пашня и пастбища
are taken for granted - воспринимаются как должное
arrange - договориться, организовать, устраивать
artificial intelligence - искусственный интеллект
as for - что касается
as you recall - как вы помните
assemble - собирать 
assessment - оценка
assets - активы
assign -   назначить, присвоить
assigned - назначенный
assignment - задание
assist - помогать
assume - предполагать
assumption - предположение
assure - гарантировать, заверить
assure - заверяю
atone-  искупать
attempt  -  пытаться, попытка
attempted - попытка
attend - посещать, присутствовать
attendance - посещаемость
attended - посещал 
attendees - посетили
attitude - отношение
Attitude - отношение
attribute - определение
audience (plural or singular) - аудитория (множественное или единственное число)
authorities - полномочия
avid - ярый, страстный, заядлый
avid - ярый, страстный, заядлый
avoid  - избегать 
aware - знать ,осознавать, выть в курсе
awareness - осведомленность, осознангость, информированность
awkward - неловкий
backslash - обратная косая черта ("/")
bankruptcy - банкротство
basement - подвал
basically - в основном, в принципе , основной, по существу
basically like - в принципе как
batch - пакет, комплектовать
Be aware - будьте внимательны
Be broke  - разорен, разбит 
be confident - быть уверенным
Bear - терпеть 
bear - терпеть ,выносить  
beg - просить, молить, умолять
begging - прошу, умоляю 
behalf - от имени
belated - запоздалый
beliefs - вера, убеждения
belongings - вещи( пожитки) 
Bench - Скамейка
benefit -  преимущество
benefits and limitations - преимущества и ограничения
Beside themselves - вне себя 
beyond - за пределами, вне
beyond - за пределами, вне(себя), после
beyond - за пределы
Bidding - участвует в торгах
blatant - явный
blunt - тупой
blurring - нечеткость, размытие 
boilerplate - шаблон
bonnet - капот
boot - ботинок
bootstrap - загружать
bottleneck - узкое место
bounties - вознаграждения, щедрость
brag - похвастаться
breach - нарушение
breakdown - анализ, отказ, крах, разбивка
breakthrough- прорыв
brew me in - заваривай меня
briefly - в двух словах, кратко
bring, carry - приносить
brotherhood -братство
buck - один доллар
buckets - групп
bugbear - проблема
bullet points -   ключевые моменты
bulletproof - пуленепробиваемый
bundle - пакет
burnout -выгорание
bush - куст
buy the stock - купить акции
by then - к тому времени
calls - случаи
capabilities - возможности
carelessly- небрежно
Casually [ˈkæʒʊəlɪ] - случайно 
catch you later! - увидимся позже!
cause -    причина
ceasefire - прекращение огня
cedar - кедр
cereal bowl - миска для хлопьев
certain - определенный
charge - ответственность, обвинение
charged - обвинен, платный
chart - график
chatgpt is at capacity right now - chatgpt сейчас работает на полную мощность
chest - грудь
chipper - бодр
choked by - подавился
Choking - задыхаться
choosey - привередливый
chunks - куски
circumstances - обстоятельства
clause - условие 
clearly -явно 
closure - закрытие
clue - путеводная нить, информировать, раскрыть тайну
clunky - неуклюжий
coastal area - прибрежная зона
cocky - дерзкий. самоуверенный
code snippet - фрагмент кода
coercion -  принуждение
collect yeast - собрать дрожжи
collision - столкновение
comb -  расчёсывать
come along with me - пойдем вместе со мной
comes up - подходит, поднимается
commit -  взять на себя обязательства, совершить
commitment - обязательство
committed - совершенный 
Committing - совершение
common sense - здравый смысл
commute-  добираться, поездка на работу и обратно, заменять
compassion - сострадание
competed - соревновались
competing - конкурирующий
competitive - конкурентоспособный
complain - жаловаться
complicated - сложный, запутанный
compose - составлять, сочинять, компоновать
composing - составление
comprehend - постигать
comprehension - понимание
comprehensive - всесторонний
concern - беспокойство, опасение
concise - лаконичный
conclude - завершать, заканчиваться
Conclusion  - завершение 
conduct - осуществлять, заниматься
conduct - проводить, поведение
confidence - уверенность
confident - уверенный
Confident - уверенный
confirmation - подтверждение
confuse - смущать, путать
consecutive - последовательный, подряд
consent - согласие
consequences- последствия
consider - рассматривать, сравнить, решать
considered   -  рассмотрен
consistent  - совместимы
constraint - ограничение
consume -поглощать (еду), потреблять (видеоматериалы) 
consuming - поглощение, потребление
contractions - сокращения
convenient - удобный
convince - убедил (конь убедил бармена налить ему винца)
correspond - переписывать, соответствовать
correspond to the reducers and state - соответствуют редукторам и состоянию.
corresponding - соответствующий
cough (sth) up - выкладывай, раскошеливайся
Coulda - мог бы
court- суд 
crawler - обходчик, сканер, гусеница
credential - удостоверение
credentials - учетные данные
cribs - кроватки
cringe - сьеживаться , вздрагивать
crisps -lorry - truck 
crop-    урожай, посев 
crossbow bolt - арбалетная стрела
cruel - жестокий
crunch - хруст, фин.кризис, 
crush - девушка, страсть
crutches - костыли , опора
cuddles - обнимашки
cumbersome - тяжелый, громоздкий
cupboards- шкафы, серванты 
curb - обочина (тротуара)
cure - средства, лекарство
curious - любопытный, любознательный
custom - пользовательский
dairy - молочные продукты
dare - осмелиться
data hoarders - накопители данных
dawn - начало, рассвет
day care - дневной уход, садик??
daytime - дневное время
deadlock - тупик
debt - долг
decent - приличный
dedicate -посвящать
dedicated - специальный, выделенный
dedicated host - выделенный хост
deduced - выведенный
deed - действие, поступок
definitely worth exploring - определенно стоит изучить.
definitive - окончательный
definitive - окончательный
Definitive - окончательный, определяющий
delay - задержка
delight - восторг
delve into the details - копаться в деталях
demand -  - спрос, требовать 
demeanor - манера поведения
denote - обозначать
dense - пустой тупой глупый
deny - отрицать
deputy -   депутат  ,  заместитель, помощник, исполняющий обязанности
DESCENDANT - потомок
descendant - потомок
deserve - заслужит
designed to enable -предназначена для того, чтобы позволить(дать возможность)
desirable - желательный
desires  - желания
desperate - отчаянный
despite - несмотря на
devote - посвятить
diary of a wimpy kid - дневник бесхарактерного ребенка
disadvantages - недостатки
disappear - пропадать
disappointed - разочарован
disarm - разоружать
disgust - отвращение
dishes -мыть посуду, подавать, блюда
Dishonored -обесчещенный
dismantle -демонтаж
disregarding  - игнорирование
disrupt - разрывать, разрушать
disruption - разрушение, нарушение
Distinct - отличный различный
distinct=(different) values - разные=( уникальные )  значения 
distinctly - отчетливо, точно, ясно
distinguish - различать
distract - отвлекать
distracted -отвлекся
disturb - беспокоить, мешать
diversity  -  разнообразие
doesn't work, either - не работает также
don't bother me with that - Не беспокойте меня этим.
Don't hesitate to start! - Не медлите с началом!
don't mention other applicants for comparison -  не упоминайте других кандидатов для сравнения
don't mess it up- не испорти все 
don't mess with the mob boss - не связывайтесь с боссом мафии
don't mess with the mob boss..
doubt - сомнение, вопрос, подозрение
Downgrade -упадок
drastically reduces stamina cost from rolling - значительно снижает затраты выносливости при перекатывании
draw - приманить
draw ,drew, drawn - рисовать, привлекать, тянуть 
draw out - а) вытаскивать; выдёргивать; вырывать
dread - боюсь
drill - дрель, учения
drills - сверла
drizzle - моросить
due - должное, ожидаемое, подобающий ,пряжо
dumb - тупица
dumb gimmicks - тупые уловки
dumb watch - тупые часы
dumps - выбрасывает
dumpster - мусорный контейнер
dunno - do not know
durability - долговечность
duty -    долг,   1) почтение, уважение,  2) (duties) налог, 
ebony - эбеновое(черное) дерево
eccentric - чудак
efficient - эффективный 
either -либо, любой ,также ,как
either direction - любое направление
elaborate - разрабатывать, конкретизировать
embed - встраивать
embedded - встроенный
embodiment - воплощение
embody -воплощать, олицетворять
embraces - охватывает , обнимает
emulate - подражать
encounter - встретить, столкнуться 
encountered - встречал, встречающийся
encouraged  - воодушевлен ( под куражем)
end up - в итоге
enforce -использует , соблюдение, исполнение
engage -заниматься, участвовать, вступать (в бой, в брак) , привлекать
engaged - вовлечен, занят, вступил( в брак )=помолвлен,
engagement - участие, помолвка
engaging hobbies- увлекательные хобби
english proficiency level assessment - оценка уровня владения английским языком
enhance - повышать, усилить
enhanced -расширенный
enhancement - улучшение, усиление 
ensure - обеспечить, убедиться
ensuring -   обеспечение, гарантия
ensuring requests - обеспечение запросов
entertaining - интересный, занимательный
entire -   весь
envelope - конверт
envy - зависть 
EQUALITY - равенство
eradicate - уничтожать
essence - суть, сущность
essentially - по сути
established -  установленный
estimated grand total - предполагаемая общая сумма
estimates -оценки
eternal - вечный
eternity - вечность
ethnicity - этническая принадлежность, нация
EVALUATED  - оценивается
even though - хотя
eventually - в конце концов, в итоге,
evidence - данные, докозательства, свидетельства
examples of impacted features - примеры затронутых функций
exceeded - превысил
excerpt - выборка, извлекать
excited - воодушевлен
exclaimed - восклицать
exercise - использовать, осуществление, тренировка, исполнение
exhaust  -исчерпывать , истощать
exhausted - исчерпан, истощен ( заебан)
exhaustive - исчерпывающий
expend - расходовать
explicit - явный
explicitly - явно
exploit - эксплуатировать
expose - разоблачение
expose - раскрывать
expressing certain opinions - выражение определенных мнений
external -    внешний
extort - вымогает
fabulous - поразительный
faces - лица, грозит 
fade - затухать , Вянуть , выгорать
fair -справедливый , честный, прекрасный
faith- вера
faithfully - верно
fame - слава
familiar-    знакомый, хорошо знакомый
farewell - прощай
feathers - перья
feature - характеристика, особенность, особенный, функция
fed up - сыт по горло, достало
feel free to attend - не стесняйтесь посещать
Festive- празднование
fever - жар
fewer - меньше
fiddle - играть
filler words - слова-паразиты
filthy- грязный, мерзкий, 
flakes - хлопья
flares - сигнальные ракеты ( сигналки )
flavour - вид
flaw - недостаток, дефект, изъян
flee - бежать, избегать
flexibility - гибкость
flip - переворачивать 
fluency - беглость, плавность
fluently - бегло, плавно
foam - пена
for a while - на время 
for a while -на  пока(на некоторое время)
for goodness sake! — ради бога!
for simplicity - для простоты
forbid - forbade - forbidden-запрещать
forbid - запрещать
forbid - запрещать, не допускать
Forbidden - запрещенный
forced - вынужденный
forced - принудительный
forces - заставляет
forecasted month end costs - прогнозируемые расходы на конец месяца
forgive - прощать, простить
forgo - воздерживаться
former - бывший
former - бывший
former experience -  прежний опыт
formerly  - бывший  
fortunately - к счастью
fortunately, that approach is changing - к счастью, данныйподход меняется
fractions -доли
fraud - мошенничество 
freak out - выйти из себя
freed - освобожденный
frequent errors - частые ошибки
frequently - часто
from the ground up - c нуля
full fledged - полноценный
funds -запасы
funeral - похороны
further  - дальнейший, дальше, дальний, далее, последующий, следующий, будущий
further - дальнейший
gain   - приобретать, получать
gasp  — вздох, ахнуть
gasped - ахнул 
gather -    собирать
generally -в целом 
generic  - общий
genuine - настоящий
get over - преодолеть, справиться, пережить, покончить , перестать
get well soon- поправляйтесь скорее
get your point across - донести свою мысль
gets up - встает
getting - становится, получение
gloomy - мрачный
goodness knows! — кто его знает!
gracefully- изящно, грациозно
granted - предоставлено 
guesstimates - предположения , гипотезы
guilty - виновен
handle  -   управлять, справляться, обрабатывать, ручка
Handle - справляться, обрабатывать
hang - повесить
harm - вред
hassling, getting on - достает/наседает/заебует
haughty -     высокомерный, заносчивый
haunt - преследовать
have a good one - всего хорошего
have a good one! - хорошего времени суток!
he surpassed everyone in strength - он превосходи́л всех си́лой
he's addicted to this game - он пристрастился к этой игре
heck - черт, блин, че за фигня
her laser sight is easier to distinguish - ее лазерный прицел легче различить.
here we go - вот и все
hereby - настоящим
hesitance - сомнение,колебание,
hesitate - стесняться, сомневаться
hesitation - колебание
hinder - препятствовать, мешать
hitch - помеха
hopeless - бессмысленно
Hostile -враждебное
how does friendship benefit people? -  как дружба приносит пользу людям?
how is it going? - как дела?
how much length of their commute - какова продолжительность их поездок на работу
how's the weather? - какая погода?
how's your day so far? - как проходит твой день до сих пор?
however -   однако 
humid - влажный
hurry up - торопиться
hush -  1) тишина; тише
i cannot bear him - я его́ не выношу́
I don't want any monkey business while we're working on this important project - Никаких глупостей, пока мы работаем над этим важным проектом.
i gotta share - я должен поделиться
I guess - я думаю
i have been involved in psychology - я занимался психологией
i like your hair or your dress. - мне нравятся твои волосы или платье.
i really appreciate your comment - я очень ценю ваш комментарий
I wanna make a shout out to Cooper- Я хочу поблагодарить Купера
i will strive to do my best- я буду стараться изо всех сил
i would shiver the whole night through - я бы дрожала всю ночь напролет
i'm getting a little sick - мне становится немного плохо
i’m ok. but kinda exhausted - я в порядке. но немного измотан.
i'm speechless -у меня нет слов
if a close friend commits a minor crime, should you tell the police? - если близкий друг совершает незначительное преступление, должны ли вы сообщить об этом в полицию?
if any changes occur, i log them - если происходят какие-либо изменения, я записываю их в журнал
if jill had gone to the meeting, the boss wouldn't be cross with her- если бы джилл пошла на встречу, босс не стал бы на неё сердиться 
if Lucy had cleaned the kitchen yesterday, James wouldn't be annoyed now - если бы люси убралась на кухне вчера, джеймс бы не раздражался сейчас.
if you do not intend - если вы не намерены
imana give you -я собираюсь дать вам 
immense - огромный
immersion - погружение
immersion in a new country is the way to learn a language - погружение в новую страну - это способ выучить язык
impact - влияние, воздействие( если подписать пакт о влиянии покемонов..экономика взлетит втрое)
impacted -повлиял, затронутых
impacting -влияет
implement - внедрять
implement all your desires - осуществит все ваши желания 
implications - последствия
implicit - неявно
IMPOSTOR - самозванец
impressed - впечатлен
impressions - показы
in essence - по сути
in many different ways - и я был вовлечен в психологию
in particular - в частности
in regard -  в отношении
In the Course - во время 
inappropriate requests - неподходящие запросы
inbound rules - входящие правила 
inclusive - включительно
inconvenience - неудобства
inconvenient - неудобно
indecision - нерешимость, неуверенность
indeed - действительно 
indent -  отступ
independently - самостоятельно
indices - индексы
indispensable - обязательный 
inducted - введен 
infer - сделать вывод
influence - влияние
injury - трамва 
insisted - настаивал
inspiration - вдохновение
instance - экземпляр
instant - мгновенный, мгновение, миг, момент
insurmountable - непреодолимый
intelligent layering - интеллектуальная многоуровневость
intend ,intent- намерение
intended -   предназначенный
intention цель, замысел
intentionally - намеренноmourners - скорбящиеformer - бывшие
intentions - намерения
intentions are one thing, but consequences are another-намерения это одно, а последствия другое.
interact  - взаимодействовать
intercept - перехват
internship - стажировка - это практика в работе.
interrupt - прерывать
intervene - вмешиваться
intrusion - вторжение
INVASIONS - вторжения
Invented - изобрели 
investigate - расследовать
invocation - просьба, вызов
invoke - вызвать
invoking  - вызов, вызывающий
involves  - включает в себя
it is too subtle - оно слишком тонкое
it screaming out - он кричит  
it turned out to be true- это оказалось правдой
it's up to you - это зависит от вас 
jealous - ревнивый 
jerk - ничтожество, сопляк
justify - оправдывать
keep it real - будь собой
keep up - не отставать  ,идти в ногу 
kerchief - платок
kind of backfire - своего рода обратный эффект
kinda - kind of -немного,  типа, как бы
knees weak - колени слабые
knot - узел
Lack - не хватает
lacking  - отсутствует ,не хватает
ladder - лестница
lamb - барашек
latency - задержка
lawfully - законно
layout -   расположение
layout - макет, разметка
leadership - руководство, лидерство
leaked - утекли
leaves - листья
left - приводил
leg up in regards … - на ногу впереди в отношении ….
legacy - устаревший ,наследие
lets tie it all up - давайте свяжем все это воедино
leverage - использовать, рычаг, кредитное плечо
liberate - освобождать
lies have consequences - ложь имеет последствия
likewise - также
lit up -засветился, загорелись
literally - буквально
loans - займ
looking forward to it - с нетерпением жду этого
loot - добыча
loot - добыча, грабить
lovely - прекрасная
lovely - прекрасный
magicprefs engaged for the magic mouse - magicprefs занимается magic mouse
magnifier - лупа
maid - служанка
maintains speech - поддерживает речь
maintenance - поддержка
make sense - иметь смысл, осмысление
make, made - заставлять
making out - целоваться
malfunction - неполадка, неисправность, сбой
malicious - вредоносный
malicious actor - злонамеренный исполнитель
mankind- человечество, человеческий род
mapping table - таблица отображения
Marital - супружеский 
maturity -зрелость
May - пусть
may occasionally produce harmful instructions or biased content - может иногда создавать вредные инструкции или предвзятый контент
measure - мера, мерить
measures - меры
mercy - милосердие
merits - заслуги, достоинства
merlin is casting its spell   - Мерлин произносит свое заклинание   
mess - беспорядок
messy - грязный
middleman - посредник 
mind - ум, разум, обратить внимание
misc - разное
miserable - жалкий, несчастный,
misleading - вводить в заблуждение
misprint - опечатка
mistake in your duties - ошибка в ваших обязанностях
mistress - хозяйка, госпожа, любовница
mitigated - смягченный
mitigations - смягчения последствий
mockup - макет
Monkey business – валяние дурака, шалость, дословно: «обезьяний труд»
moreover - более того
mortage - смертельный исход
most anticipated - самый ожидаемый
my car has a high consumption of gas - у моей машины большой расход бензина
my goodness! — боже мой!
namely - а именно
native -    родной, собственный 
naughty - непослушный
negotiate - вести переговоры, согласовывать
nested - вложенный, наследуемый
never mind - неважно
nevermind -    не берите в голову
nevertheless - тем не менее
newbie - новичок
No fuss - Без суеты
number - количество
object - цель, возражать
objective -цель, задача
obscurity - неясность
Observant - соблюдающий
obsessed -  одержимый
OBSESSED WITH SEX - ОДЕРЖИМЫЙ СЕКСОМ
obsession - страстное увлечение, одержимость, мания 
obsolete - устаревший, редко используемый
obtained - получено
obviously - очевидно
occasion - возможность ,шанс, случай, повод
Occasion - мероприятие 
occupation - занятие (род деятельности)
odds - шансы
offensive - наступательный
okay so - хорошо, так
omit - опускать
On my own - Сам по себе
onboarding - адаптация
once - раньше, один раз, однажды, когда то
ope - ой
operation not permitted - операция не разрешена
others' feeds - ленты других
otherwise - иначе
outbound rules - исходящие правила 
outlet - точка продаж
outlined - описанных
over - закончилось
overdue - просроченный
overflow occurs - переполнение происходит
override  - переопределение
overtime - сверхурочное время, сверхурочно
overwhelmed - перегруженный
overwhelming - ошеломляющий , подавляющий , подавляющее большинство, перевешивание
pace-темп, скорость, шаг
pantry - кладовая
partial  - частичный
participate - участвовать
participle - причастие
particularly - особенно
patience - терпение
payload   - полезная нагрузка
peer   - равный, равноправный одноранговая
perceive -ощущать, видеть
perform - выполнять
performance -   производительность, выполнение, показатели 
performer - исполнитель 
Performing [pərˈfɔːrm] - показывать
Period - точка
perk -льгота, плюшка ,преимущество
permanent - постоянный, долговременный
permitted - разрешено
persist - сохраняться
persistent - постоянный, стойкий
persists - сохраняется
pertain - принадлежать, относиться
pipeline - конвейер
pity - пожалеть, жалость, сожаление, сочувствие, сострадание, жаль
pivot - опорный
playback - проигрывание
pleading- признание
please kindly - пожалуйста, будьте добры
pleasure, enjoyment - наслаждение
plugged - подключен
pod -стручок
point    - смысл, суть, указывать
point out - указывать
pointer - указатель, стрелка
politeness - вежливость
poll - опрос
poo- poop - какашки
populate fields - заполните поля
positive impact - положительное влияние, позитивное воздействие, позитивное влияние, позитивный эффект
postpone- отложить 
posture - поза
potty - горшок
precautions- меры предосторожности, предостережения
preceding - предшествующий
precise - точный
precise - точный, четкий
precisely - точно
predefine - предопределять
predicament - затруднение, затруднительное положение
predicate -сказуемое
predict - предсказывать
preference - предпочтение
prejudgement - предрассудок, предвзятость, предубеждение
prejudice - предрассудки
preliminary - предварительный
prerequisite - предпосылка
Present - присутствующих 
preserve  - сохранять
pretty cool breakdown - довольно крутая разбивка
prevent - предотвращать, препятствовать
prevented - предотвращено
priceless - бесценный
pricked -  укололся
proficiency - профессионализм
profound - глубокий, основательный
prohibit - запрещать, препятствовать
promoted - повысить
prompts - подсказки
proper - надлежащий, должный, правильный
properly -как следует, нормально, правильно
properly indent - правильный отступ 
property- недвижимость, собственность, территория, свойство
propose - предлагать
propose - предложение
pros and cons - за и против 
prosecutors authorise - прокуроры выдвинули
pull over - остановиться, притормозить, прижаться
pulls on me - проделывает со мной
pup- щенок
purpose - цель, назначение
pursue - продолжать
quietly - тихо
rape - изнасилование
rate - скорость
rather -вернее, скорее, довольно, достаточно 
rather than -вместо, нежели
reasserted - подтверждено
recession  - спад
recite - прочесть, произнести, повторить
recite - читать,произносить
Reconcile - примирение ( мирить)
rectify - исправить
redemption - искупление
reduces resistance to knockback - снижает устойчивость к обратным ударам 
redundant - лишний, излишний, избыточный
refine - улучшить, усовершенствовать
refuse -откажусь
regard - рассматривать, внимание
regarding your application - (o) , относительно вашего заявления.
regret - сожаление, fear is temporary regret is forever 
regret - сожалеть
regular  - обычный
reliable - надежный
Reliance - опора
relieve - помогать, освобождать
remain - оставаться, пребывать
remain engaged throughout the class -  оставайтесь вовлеченными на протяжении всего занятия
remaining files - оставшиеся файлы
representing  - представляем
request - запрос
resigned - уволился, уходить в отставку, отказаться, смириться
resistance points - точки сопротивления
resolution of these errors -  разрешение этих ошибок
response - ответ
responsibility - зона ответственности
responsible - ответственен
restrict -ограничивать
restricted area-запретная зона
restricted mode - ограниченный режим
retired - в отставке
Retirees - Пенсионеры
retrieval - извлечение
retrieving - извлечение, восстановление
revamped- обновленный
reveal - показать, раскрыть, открывать, разоблачать
reveal - показывать, выявить , обнаружить, открыть
Reveal - Раскрыть, открыть , выявить
reveal desktop edge - раскрыть край рабочего стола
revealed - выявлено, раскрыто, обнародовано
revelation - расскрытие
revenue - доход
revert - возвращаться
revoke - отозвать
ribs - ребра 
rippers - потрошители
robust - устойчивый
rolled out- развернута
rough guy - грубый парень
royalty - авторский гонорар, отчисления
rudimentary - элементарный
ruin - разрушать
run out of - израсходовать, истощать запасы
running - подряд, течет, прибывает
runs out - выбегает ,истекать, кончаться 
sacrifice - жертва
sacrifice -жертвовать
sake - польза
sake - ради
salvation - спасение
sampled - выбран
sapling - деревце
sausages barrister - attorney 
Savage - дикарь
saving you lots of time and energy - значительная экономия ваших сил и времени
sawblade - диск(болгарки)( лезвие пилы)
scare - пугать
scramble - бороться, сколотить, сбить, разбить
scrapping - соскоб
SECURE - получают
seize , capture - захватить
seized - изъяли ( большой размер наркоты) 
self-effacing самодоволен
self-sacrifice самопожертвование
selfless - самоотверженный
semiconductor - полупроводник
seniority - старшинство
sensibly - с умом
sensual - чувственный
sequence -   последовательность
sequences -Последовательность
sequentially - последовательно
set an appointment - назначить встречу
set him off - вывести его из себя
settle - решить,урегулировать, поселиться
settles legal dispute for $787.5m - урегулирует судебный спор на сумму $787,5 млн.
severe - жесткий, тяжелый 
Sewage - канализация
sewing шьет
share with your thoughts - поделитесь своими мыслями
she was doing it on purpose - она дела это нарочно ( с целью)
she'll pity -она посочувствует
shiv - заточка
shoulda- следовало бы 
showing kindness and concern - проявление доброты и заботы
shrink image - уменьшить изображение 
sight - взгляд, зрение
significant - важный
significantly - значительно
silly - глупый
simultaneously - одновременно
Sink in - вникать погружаться , задуматься
sinking - тонет
skew -  наклон
Slapping -удар, хлопок, шлепок
slew (slay) - убил
slightly  - немного, слегка
Slip - скользить
Slip - ускользнуть 
slip - ускользнуть 
Snake was Chasing me - Змея преследовала меня🐍 
snap - щелчек, внезапно
sneeze - чихать
so far - до сих пор
So go on. Tear it up. - Так что продолжайте. Порвите его.
so that meant we were gonna have to make a run for it - это означало что мы должны были убегать
social network - соц сети
society - общество
somewhat - немножко
sore subject - больная тема
sorrow - горе, печаль , скорбь
sparingly - экономно
spark - вызвать, искра
specified - указанный
spell, spelt, spelled - писать или произносить (слово) по буквам 
spelling - написание
splice - соединение
spoil - портить
spouse - супруг
Squat - приседание
ssh client can maintain a persistent connection -  клиент ssh может поддерживать постоянное соединение 
stabbed - порезана
stack trace all over the screen - стек вызовов на всем экране
Stagnant - вялый, стоячий, застойный 
Stain - пятно
staring to my ass - пялится на мою задницу
statement - заявление, оператор
stay abreast - будьте в курсе
stood out - выделялся 
strain-   сорт
Straw - солома, соломинка
strictly speaking - строго говоря
string obtained from the name property - строка, полученная из свойства name
strip - полоса
strips -лишает-(полоски последней лишилась стриптизерша)
stripy  -полосатый
struggle - борьба, боролся
students should attend classes regularly - студенты должны присутствовать на уроках регулярно
stuff - материал, наполнять
subject  - подлежащее
subtract - вычитать
successfully terminated - успешно завершено 
succumb - поддаться , уступить
suddenly - внезапно, вдруг
sued - подал в суд
suffice - удовлетворять, быть достаточным
sufficient-достаточно
supplements - добавки
supply -  поставка, подача, поставлять 
suppose - полагать, предполагать
suppose - предполагать
suppose - предполагать
suppressor - глушитель
surface - поверхность
surge - всплеск
surgery - хирургия
surpass -    превосходи́ть 
surprisingly good in brownies - удивительно хорош в пирожных
survey - опрос
suspect - подозревают
suspended - приостановлено
swap driver - замена драйвера
sway - качание
swear - клятва
swear to me - поклянись мне
sweaty palms - потные ладони 
swindled - выманила
syllable - cлог
tailor your cv - составьте свое резюме
take care! - береги себя!
taught - учил, преподавал, обратился
tearing - разрыв
tenancy - аренда
tend - имеет тенденцию, как правило, стремится
tense - напряжение
tense - напряженный, натянутый
ternary - троичный
testify - свидетельствовать
that is - т.е. ( то есть )
the crucial part - ключевая роль
The sincerest prayer  - самая искренняя молитва
the software computes the total automatically - эта программа вычисляет итог автоматически.
The Underdogs: Swiped Mac - Недотепы: Похищенный Мак 
Therefore - поэтому
therefore - поэтому 
therefore - поэтому ( там 4 негра поэтому белому туда лучше не соваться)
they will schedule another meeting - они назначат другую встречу
thick - толстый, полный
thirst - жажда
thirsty  - жаждущий
this case is useful for either application - этот случай полезен для любого приложения
thoroughly - тщательно, полностью
thou -   ты
though - хотя, правда, даже, однако, несмотря на, тем не менее,
thread  -поток, нитка, тема нанизывать
threat - угроза
threshold - порог
throat - горло
through - прямо, насквозь, через
throw - бросить, бросок
thus -     так, таким образом, следовательно
thus - так, таким образом--(зас)
tier - тип, уровень
tight - крепко
to be going to have  - должен буду, должны будем-  
to find out what time the film starts - выяснить, когданачинается фильм.
to go over everything - чтобы обсудить все.(пройтись по всему)
to keep doing sth - продолжать ( делать что-либо)
tough - жесткий
tow - буксир
towel - полотенце
traction - тяга
trap - лестница 
treasure - сокровище
treat- 1. лечить 2. относиться 3.обращаться
treats - угрозы
troubleshooting - Поиск неисправностей
truce - перемирие
truly - истинно
trump liable for sexual assault - Трамп несет ответственность за сексуальное насилие
truncate - сокращать
turkey  -   1) индюк; индейка 2) разг. неудача, провал 3) амер.; разг. тупица, ничтожество; медлительный человек, тюфяк 
turn out - оказываться, выяснить 
tweaking - тонкая настройка
typo - опечатка
ultimately - в конечном итоге
unaware - неосведомлённый
underfucked - недоебанный
unexpected token - неожиданный знак
unholy - wicked - плохой (злой, нечестивый)
until we meet again! - до наших следующих встреч!
upcoming - предстоящий
upright - вертикальный
upset - крах , расстройство, нарушение (планов)
upstairs - наверху
urge - порыв, сильное желание
urgent -срочно
utilize - использовать
vault - хранилище, подвал, склеп
versatile - многофункциональный, универсальный
via - с помощью,через
viz. - а именно , то есть 	 
vomit - блевотина
Vomit - рвота 
vulnerabilities - уязвимости
watched it pour - наблюдал, как она наливается
We also invite you to remain engaged with our community - Мы также приглашаем вас продолжать взаимодействовать с нашим сообществом
we are committed to protecting human rights - мы привержены защите прав человека
we are sinking - мы тонем
we trigger - мы запускаем
we will proceed with the second approach - мы продолжим со вторым подходом
we've only had one honest man so far - до сих пор у нас был только один честный человек
wealth - богатство
wealthy - богатый, состоятельный
weird - странные
weird - странный
whale - кит
what are you up to - что ты задумал 
what do mermaids wash their fins with?  - чем русалки моют свои плавники? 
what do you do for a living - чем ты зарабатываешь на жизнь 
what have you been up to? -чем вы занимались?
what made you busy today? - что заняло тебя сегодня?
what was it - что это было 
whatever - неважно
wheel  steering  - рулевое управление  
when you show genuine concern -когда вы проявляете искреннюю заботу.
whereas -в то время как
whether - было ли, ли, или
widely - широко
wire -  провода
wisdom - мудрость
wise - мудрый
With - от 
withdraw - вывести
Witnessed [ˈwɪtnəst] - свидетель
Worship - поклоняться, служить
worth  - стоить
woulda - бы
wounds - раны
wrath - гнев
yet - еще не
You better brave that storm.  - Лучше отважьтесь на шторм.  
you may assume - вы можете предположить
you need to have a growth mindset. - у вас должно быть мышление роста.
you want a strafing run? look out - хотите провести обстрел? осторожно
you were mentioned in this post - вы были упомянуты в этом посте
ближайшее - nearest
бросить - throw ,drop
вести дневник - keep a diary
власть - authority
вместе - together
вместо - instead of
возраст - age
голос знакомый - the voice is familiar
зависит - depends
заказать - to order 
зарабатываю - earn
исключение - exception
как правило - as a rule 
маке sense - иметь смысл
Мешать , беспокоить - disturb 
мешаю - interrupt 
мудрый - wise 
муха - fly
на кого я похож - who do i look like
начало - beginning
по разному - differently
предпоследний - penultimate
путать - confuse
совмещать - combine
тем не менее - nevertheless