🇮🇱 🇮🇱 🇮🇱 hebrew words 


_______________________

бездельничать - לְהִסְתַּלְבֵּט
бутон, почка - ניצן
вознаграждение, награда - תגמול
выдумка, чушь собачья -  קישקוש
детвора - טף
есардут - выживание - הישרדות
Жалею - מתחרט
залив - מפרץ
Картирование - מיפוי
каша, месиво - עיסה 
Командование тыла - פיקוד ‎ העורף
Лецорех аиньян - לצורך העניין - к примеру 
ло бээхрах - не обязательно 
Ненормально - באופן חריג
обивка - ריפוד
обижаться - נעלב
оптовый - סיטונאי
Отдых, развлечения - בילוים
плохо, легкомысленно - חפיף
подавился, задыхался - נחנק
подходящий, правильный - ראוי  
пожалел, передумал - התחרטתי  - итхаратети 
Разочаровывающий - מאכזב
сбивать, дать пощечину - סוטר
слишком жестоко на мой вкус - אכזרי  מדי לטעמי
смурфики - דרדסים
смягчит - ירכך    
сотрудничество - שיתוף הפעולה
специфика-  ייחוד, ספציפיות
тайный - סמוי
тендер конкурс - מכרז
тизмун - сроки- - תזמון 
товар - סחורה
тонуть , погружаться - שוקע
убить - להתנקש
уставший (сленг) - שפוך - шафух
хамса хамса - не дай бог
хасифа- חשיפה - уязвимость
хасуф -раскрытый - חשוף 
Чередование -סירוגין
честность , искренность - כנות
экскурсия , патруль - סיור
эскалатор - מדרגות נעות
אחד משמעי - однозначно  
אילוצים - ограничения
אל תמציא - аль тамци - не изобретай ,Не выдумывай
אָשֵׁם - Виновен
אתגר -  вызов ,челендж - этгар
בוגד - предатель
בול - буль, точно
בולטת - выделяется
בְּחַיָאת רַבַּאק  - Бхият рабак - ну типа,ну уж, ей-богу (араб.)  
בְּטֶרֶם - Прежде чем
במקביל - одновременно, параллельно
בתמורה-   в обмен,  замен 
דיוורים - рассылки    
דמות - образ.персонаж
החשיפה - Воздействие, открытие , разоблачение
העדרות - отсутствие
הפקה-  производство
הַצִּק - Беспокоило
הקיצוצים- сокращения
הִתְפַּשֵּר - Пошел на компромисс (уступки)
הִתְרַעַנְנוּת - Освежение
זהה - то же самое
חומרה - оборудование
חזון - видение
חנון - ботан
חסינות -иммунитет 
חפיפה - введение в курс дел
חַפִּירָה - Лопата, раскопки
חצי קלאץ - хаци клач - (сцепление) пол силы... неоч... такое... 
חריג מאוד-  хариг меод - необычный,исключения
טווחי השכר - зарабатная вилка
טָרֶשֶׁת נְפוֹצָה - Рассеянный склероз
יס"מ - יחידת הסיור המיוחדת
ישות— сущность -ешут- ентити 
יתמהמה - задержится 
כִּבְיָכוֹל - Как-будто
כיול - Калибровка
כיול- калибровка 
כלפי מטה - снизу
כנ
כף רצח - кейф рецах - Лучший,(убийственно кайфовая)
לא סגור על זה   - не уверен в этом—ло сагур ал зе 
לֹא עַד כַּדֵּי כָּךְ - Не настолько 
לָאוּ דַּוְקָא - Необязательно
לאטום -закупорить
להבריח - контрабанда
להזין- леазин - вводить, питать, кормить
להימנע - Воздержаться
להכפיל - умножить 
להמיר - конвертировать , поменять
להמנע - Избежать
להציץ -  взглянуть
להציק - Дразнить, доставать
לְהַצְפִּין - Зашифруйте
להרים דגל - поднять флагсообщить что есть проблема 
להתמקד - сосредоточиться 
להתעלם -пропадать, игнорировать
לומדה - ломда -руководство 
לזלזל - недооценивать
לחדד- уточнить 
לחות - влага  
לחילופין - как вариант, наоборот
לְחַלֵּץ - Высвобождать, извлекать
לחשוף - расскрыть 
לטרוק - хлопать
לְמַזֵּג - Объединить
לְסָרֵב - Отказать 
לסרוק - прочесать
לפצל - разделить
לפרגן - похвалить 
לקלל - ругаться 
לשלב - сочетать соединять объединять
מִבְנֶה - Структура, меню
מגוון- разнообразие, спектр
מדחפים - двигатели
מדיניות - политикой
מדיניות -правила
מהמם - меамем - прекрасно 
מושבת - поврежден, отключен , не работает 
מחטב -утягивающее белье 
מחרפן - нервируешь
מיפוי - отображение
מַכְלוּל - Комплекс
מְמוּיָן - Отсортированный
ממוקדים -сосредоточены, сфокусированы
ממילא -  мимейле - и так, всё равно
מן הסתם - мин а стам - очевидно, наверняка, возможно
מַנְגָּנוֹן- мангенон - механизм
מסתדר - Получается
מפונק - Избалованный
מְפֻטָּר  - мефутар - уволен
מְפַקֵּחַ - Инструктор, начальник, лейтенант
מצורף בזאת - מצ"ב 
מצחצח -чистить
מקוונת - — онлайн 
מקרטע- отключается мекартеа 
מֶרְחָב - Пространство
מרצד - Мигание, мерцание
משגעת - сводит с ума
משובש -мешубаш-сломан, искажен, разрушенный
משכך - Облегчить (мешакех)
מתבאס -разочаровываться(баса-разочарование), растраивается, огорчается 
מֶתֵּג - Выключатель, переключатель
מתוסכל-מְתֻסְכָּל - Расстроен, разочарован ,расстроенный 
מתחם - комплекс.периметр
מתחרה - конкурент
מתחרים - конкуренты, соревнуемся
מתחרקש - ебать мозг, вмешивается
מתחשק -хочется
מתנקש - киллер, убийца
מתקתק - тикает
מתרחש - происходит
נחוצים - нужны
נְחִישׁוּת - решимость, упорство, стремление, Определение
ניכר בהחלט - абсолютно очевидно.. 
נִמְנַע - Избежать
נִסְעָר - Расстроен
נִפּוּק - В процессе
נָפַל לִי אֲסִימוֹן - До меня наконец дошло
נִשְׁבַּץ - Поставим
סיוט - кошмар
סילון - реактивный
ספיר - сапфир
סתלבט - расслабон, отдых, подкалывать, шутить 
עוֹנֶשׁ - Наказание
עוף מכובס - оф мехубас - постоянно повторяющася ситуация
עַכְבִּישִׁים - Пауки
על הכיפאק - супер.нормальный, с удовольствием, ура, потрясающе, очень хорошо.
עקום - кривой
עֲקִיפָה - Обход
פגז - отлично 
פוֹלֵשׁ - Вторгается
פוריה - плодотворная
פער - пар - разрыв, разница
פרטני - индивидуально, по отдельности 
פִּרְעוּן - Погашение
פרעושים - блохи вши
צוואר - шея 
צורח - кричит
ציר - ось
צָמִיד  - браслет - цамид 
קושחה -  прошивки
קטלן - убийца
קטלנית - смертельный... офигенно..ужасно.. 
קיצוני - крайний, радикальный
קלוש - слабый
קפצתי להזכיר - поспешил напомнить
קשוב - внимательный 
רצועה - ремень
רתמתי - привязал
שאילתא - шеильта -вопрос,запрос
שאיפה - шеифа - амбиции... стремление
שַׁאֲפָתָן - Амбициозный
שבויים - пленные
שיבוץ -расписание, внедрение 
שיח - Диалог разговор 
שיקול דעת - шикуль даат - взвесить мнения 
תזניחי - пренебрегать
תיקנים - тараканы 
תכולות - содержание
תכולת - содержание
תכונת -  функции
תמורה - возврат 
תנחשו - угадайте
תפגיז - зажигай
תקן - стандарт
_________________________

